{
    "doors" : [

        { "x":192, "y":64, "width":48, "height":48,
        "destination_zone":"01", "destination_x":0, "destination_y":-1 }

    ],

    "columns":12,
    "rows"   :9,

    "graphical_map":[13, 13, 13, 13, 13, 13, 13, 13, 13, 13, 13, 13, 
              13, 13, 13, 13, 13, 13, 13, 13, 13, 13, 13, 13, 
              13, 13, 13, 13, 13, 13, 13, 13, 13, 13, 13, 13, 
              35, 38, 38, 34, 38, 36, 33, 36, 38, 34, 38, 35, 
              58, 58, 58, 58, 58, 57, 58, 59, 58, 58, 58, 58, 
              15, 15, 15, 15, 15, 15, 15, 15, 15, 15, 15, 15, 
              15, 15, 15, 15, 15, 15, 15, 15, 15, 15, 15, 15, 
              15, 15, 15, 15, 15, 15, 15, 15, 15, 15, 15, 15, 
              22, 23, 22, 23, 22, 23, 22, 23, 22, 23, 22, 23],

    "collision_map":[0,0,0,0,0,0,0,0,0,0,0,0,
                      0,0,0,0,0,0,0,0,0,0,0,0,
                      0,0,0,0,0,0,0,0,0,0,0,0,
                      0,0,0,0,0,0,0,0,0,0,0,0,
                      0,0,0,0,0,0,0,0,0,0,0,0,
                      0,0,0,0,0,0,0,0,0,0,0,0,
                      0,0,0,0,0,0,0,0,0,0,0,0,
                      0,0,0,0,0,0,0,0,0,0,0,0,
                      1,1,1,1,1,1,1,1,1,1,1,1],

    "id":"0"

}